x,x,x,x,x,x,x,x,x,x,x,x,x,x,x,x,x,x,x,x,.,s,s,s,.,x,x,x,x,x,x,x,x,x,x,x,x,x,x,x,x,x,x,x,x
x,x,x,x,x,x,x,x,x,x,x,x,x,x,x,x,x,.,.,.,.,.,.,.,.,.,.,.,x,x,x,x,x,x,x,x,x,x,x,x,x,x,x,x,x
x,x,x,x,x,x,x,x,x,x,x,x,x,x,x,.,.,.,.,.,.,.,.,.,.,.,.,.,.,.,x,x,x,x,x,x,x,x,x,x,x,x,x,x,x
x,x,x,x,x,x,x,x,x,x,x,x,x,.,.,.,.,.,.,.,.,.,.,.,.,.,.,.,.,.,.,.,x,x,x,x,x,x,x,x,x,x,x,x,x
x,x,x,x,x,x,x,x,x,x,x,.,.,.,.,.,.,.,.,.,.,.,.,.,.,.,.,.,.,.,.,.,.,.,x,x,x,x,x,x,x,x,x,x,x
x,x,x,x,x,x,x,x,x,.,.,.,.,.,.,.,.,.,.,.,.,.,.,.,.,.,.,.,.,.,.,.,.,.,.,.,x,x,x,x,x,x,x,x,x
x,x,x,x,x,x,x,x,.,.,.,.,.,.,.,.,.,.,.,.,x,x,x,x,x,.,.,.,.,.,.,.,.,.,.,.,.,x,x,x,x,x,x,x,x
x,x,x,x,x,x,x,.,.,.,.,.,.,.,.,.,.,.,x,x,x,x,x,x,x,x,x,.,.,.,.,.,.,.,.,.,.,.,x,x,x,x,x,x,x
x,x,x,x,x,x,.,.,.,.,.,.,.,.,.,x,x,x,x,x,x,x,x,x,x,x,x,x,x,x,.,.,.,.,.,.,.,.,.,x,x,x,x,x,x
x,x,x,x,x,.,.,.,.,.,.,.,.,.,x,x,x,x,x,x,x,x,x,x,x,x,x,x,x,x,x,.,.,.,.,.,.,.,.,.,x,x,x,x,x
x,x,x,x,x,.,.,.,.,.,.,.,x,x,x,x,x,x,x,x,x,x,x,x,x,x,x,x,x,x,x,x,x,.,.,.,.,.,.,.,x,x,x,x,x
x,x,x,x,.,.,.,.,.,.,.,x,x,x,x,x,x,x,x,x,x,x,x,x,x,x,x,x,x,x,x,x,x,x,.,.,.,.,.,.,.,x,x,x,x
x,x,x,x,.,.,.,.,.,.,x,x,x,x,x,x,x,x,x,x,x,x,x,x,x,x,x,x,x,x,x,x,x,x,x,.,.,.,.,.,.,x,x,x,x
x,x,x,.,.,.,.,.,.,x,x,x,x,x,x,x,x,x,x,x,x,x,x,x,x,x,x,x,x,x,x,x,x,x,x,x,.,.,.,.,.,.,x,x,x
x,x,x,.,.,.,.,.,x,x,x,x,x,x,x,x,x,x,x,x,x,x,x,x,x,x,x,x,x,x,x,x,x,x,x,x,x,.,.,.,.,.,x,x,x
x,x,x,.,.,.,.,.,x,x,x,x,x,x,x,x,x,x,x,x,x,x,x,x,x,x,x,x,x,x,x,x,x,x,x,x,x,.,.,.,.,.,x,x,x
x,x,.,.,.,.,.,x,x,x,x,x,x,x,x,x,x,x,x,x,x,x,x,x,x,x,x,x,x,x,x,x,x,x,x,x,x,x,.,.,.,.,.,x,x
x,x,.,.,.,.,.,x,x,x,x,x,x,x,x,x,x,x,x,x,x,x,x,x,x,x,x,x,x,x,x,x,x,x,x,x,x,x,.,.,.,.,.,x,x
x,.,.,.,.,.,x,x,x,x,x,x,x,x,x,x,x,x,x,x,x,x,x,x,x,x,x,x,x,x,x,x,x,x,x,x,x,x,x,.,.,.,.,.,x
x,.,.,.,.,.,x,x,x,x,x,x,x,x,x,x,x,x,x,x,x,x,x,x,x,x,x,x,x,x,x,x,x,x,x,x,x,x,x,.,.,.,.,.,x
x,.,.,.,.,.,x,x,x,x,x,x,x,x,x,x,x,x,x,x,x,x,x,x,x,x,x,x,x,x,x,x,x,x,x,x,x,x,x,.,.,.,.,.,x
.,.,.,.,.,x,x,x,x,x,x,x,x,x,x,x,x,x,x,x,x,x,x,x,x,x,x,x,x,x,x,x,x,x,x,x,x,x,x,x,.,.,.,.,.
.,.,.,.,.,x,x,x,x,x,x,x,x,x,x,x,x,x,x,x,x,x,x,x,x,x,x,x,x,x,x,x,x,x,x,x,x,x,x,x,.,.,.,.,.
.,.,.,.,.,x,x,x,x,x,x,x,x,x,x,x,x,x,x,x,x,x,x,x,x,x,x,x,x,x,x,x,x,x,x,x,x,x,x,x,.,.,.,.,.
.,.,.,.,.,x,x,x,x,x,x,x,x,x,x,x,x,x,x,x,x,x,x,x,x,x,x,x,x,x,x,x,x,x,x,x,x,x,x,x,.,.,.,.,.
.,.,.,.,.,x,x,x,x,x,x,x,x,x,x,x,x,x,x,x,x,x,x,x,x,x,x,x,x,x,x,x,x,x,x,x,x,x,x,x,.,.,.,.,.
.,.,.,.,.,x,x,x,x,x,x,x,x,x,x,x,x,x,x,x,x,x,x,x,x,x,x,x,x,x,x,x,x,x,x,x,x,x,x,x,.,.,.,.,.
.,.,.,.,.,x,x,x,x,x,x,x,x,x,x,x,x,x,x,x,x,x,x,x,x,x,x,x,x,x,x,x,x,x,x,x,x,x,x,x,.,.,.,.,.
.,.,.,.,.,x,x,x,x,x,x,x,x,x,x,x,x,x,x,x,x,x,x,x,x,x,x,x,x,x,x,x,x,x,x,x,x,x,x,x,.,.,.,.,.
x,.,.,.,.,.,x,x,x,x,x,x,x,x,x,x,x,x,x,x,x,x,x,x,x,x,x,x,x,x,x,x,x,x,x,x,x,x,x,.,.,.,.,.,x
x,.,.,.,.,.,x,x,x,x,x,x,x,x,x,x,x,x,x,x,x,x,x,x,x,x,x,x,x,x,x,x,x,x,x,x,x,x,x,.,.,.,.,.,x
x,.,.,.,.,.,x,x,x,x,x,x,x,x,x,x,x,x,x,x,x,x,x,x,x,x,x,x,x,x,x,x,x,x,x,x,x,x,x,.,.,.,.,.,x
x,x,.,.,.,.,.,x,x,x,x,x,x,x,x,x,x,x,x,x,x,x,x,x,x,x,x,x,x,x,x,x,x,x,x,x,x,x,.,.,.,.,.,x,x
x,x,.,.,.,.,.,x,x,x,x,x,x,x,x,x,x,x,x,x,x,x,x,x,x,x,x,x,x,x,x,x,x,x,x,x,x,x,.,.,.,.,.,x,x
x,x,x,.,.,.,.,.,x,x,x,x,x,x,x,x,x,x,x,x,x,x,x,x,x,x,x,x,x,x,x,x,x,x,x,x,x,.,.,.,.,.,x,x,x
x,x,x,.,.,.,.,.,.,x,x,x,x,x,x,x,x,x,x,x,x,x,x,x,x,x,x,x,x,x,x,x,x,x,x,x,.,.,.,.,.,.,x,x,x
x,x,x,.,.,.,.,.,.,.,x,x,x,x,x,x,x,x,x,x,x,x,x,x,x,x,x,x,x,x,x,x,x,x,x,.,.,.,.,.,.,.,x,x,x
x,x,x,x,.,.,.,.,.,.,.,x,x,x,x,x,x,x,x,x,x,x,x,x,x,x,x,x,x,x,x,x,x,x,.,.,.,.,.,.,.,x,x,x,x
x,x,x,x,.,.,.,.,.,.,.,.,x,x,x,x,x,x,x,x,x,x,x,x,x,x,x,x,x,x,x,x,x,.,.,.,.,.,.,.,.,x,x,x,x
x,x,x,x,x,.,.,.,.,.,.,.,.,x,x,x,x,x,x,x,x,x,x,x,x,x,x,x,x,x,x,x,.,.,.,.,.,.,.,.,x,x,x,x,x
x,x,x,x,x,.,.,.,.,.,.,.,.,.,x,x,x,x,x,x,x,x,x,x,x,x,x,x,x,x,x,.,.,.,.,.,.,.,.,.,x,x,x,x,x
x,x,x,x,x,x,.,.,.,.,.,.,.,.,.,x,x,x,x,x,x,x,x,x,x,x,x,x,x,x,.,.,.,.,.,.,.,.,.,x,x,x,x,x,x
x,x,x,x,x,x,x,.,.,.,.,.,.,.,.,.,.,.,x,x,x,x,x,x,x,x,x,.,.,.,.,.,.,.,.,.,.,.,x,x,x,x,x,x,x
x,x,x,x,x,x,x,x,.,.,.,.,.,.,.,.,.,.,.,.,x,x,x,x,x,.,.,.,.,.,.,.,.,.,.,.,.,x,x,x,x,x,x,x,x
x,x,x,x,x,x,x,x,x,.,.,.,.,.,.,.,.,.,.,.,.,.,.,.,.,.,.,.,.,.,.,.,.,.,.,.,x,x,x,x,x,x,x,x,x
x,x,x,x,x,x,x,x,x,x,x,.,.,.,.,.,.,.,.,.,.,.,.,.,.,.,.,.,.,.,.,.,.,.,x,x,x,x,x,x,x,x,x,x,x
x,x,x,x,x,x,x,x,x,x,x,x,x,.,.,.,.,.,.,.,.,.,.,.,.,.,.,.,.,.,.,.,x,x,x,x,x,x,x,x,x,x,x,x,x
x,x,x,x,x,x,x,x,x,x,x,x,x,x,x,.,.,.,.,.,.,.,.,.,.,.,.,.,.,.,x,x,x,x,x,x,x,x,x,x,x,x,x,x,x
x,x,x,x,x,x,x,x,x,x,x,x,x,x,x,x,x,.,.,.,.,.,.,.,.,.,.,.,x,x,x,x,x,x,x,x,x,x,x,x,x,x,x,x,x
x,x,x,x,x,x,x,x,x,x,x,x,x,x,x,x,x,x,x,x,.,g,g,g,.,x,x,x,x,x,x,x,x,x,x,x,x,x,x,x,x,x,x,x,x